tropical = {  
}
arid = { 
}
arctic = { 
}
#Example:Most of Europe north of med.
mild_winter = { 
	18 20 21 64 65 68 70 71 72 101
	105 106 108 109 112 113 114 115 116 117
	129 130 131 132 133 134 135 136 137 138
	139 140 141 143 144 147 152 153 154 156
	160 161 165 174 175 178 179 180 190 191
	192 193 194 195 196 198 199 200 203 213
	222 223 226 265 266 267 282 283 284 285
	286 287 288 290 291 313 315 330 331 344
	413 417 418 421 428 439 440 450 451 455
	456 457 458 464 465 466 468 469 472 476
	508 509 511 554 557 565 576 578 646 695
	696 698 704 732 788 789 886 888 898 917
	919 923 927 928 930 933 934 939 950 952
	953 959 979 1025 1034 1036 1037 1038 1039 1073
	1085 1167 1174 1175 1176 1177 1178 1179 1180 1181
	1182 1184 1185 1186 1187 1188 1191 1192 1193 1194
	1195 1200 1202 1205 1224 1227 1238 1240 1265 1273
	1318 1433 1442 1459 1461 1462 1464 1474 1475 1486
	1493 1498 1505 1524 1525 1540 1561 1562 1610 1633
	1634 1635 1636 1637 1638 1639 1640 1641 1668 1691
	1698 1746 1756 1757 1766 1767 1770 1772 1776 1777
	1780 1781 1782 1783 1788 1797 1798 1807 1814 1816
	1826 1827 1828 1831 1853 1862 1863 1864 1867 1868
	1869 1870 1872 1877 1880 1886 1887 1924 1925 1943
	1944 1954 1955 1967 1968 1970 1971 1974 1987 1988
	1994 1997 2001 2003 2008 2014 2015 2068 2069 2070
	2073 2113 2138 2195 2199 2208 2210 2211 2216 2217
	2218 2222 2225 2227 2305 2306 2351 2365 2366 2367
	2405 2406 2409 2410 2411 2412 2413 2414 2416 2417
	2420 2447 2467 2468 2478 2481 2483 2485 2493 2494
	2496 2513 2515 2526 2527 2535 2537 2539 2542 2544
	2559 2592 2593 2594 2595 2596 2597 2605 2607 2628
	2640 2647 2650 2651 2654 2665 2666 2746 2753 2756
	2766 2771 2778 2780 2783 2784 2787 2858 2913 2914
	2915 2916 2917 2925 2948 2949 2955 2956 2957 2968
	2970 2977 2978 2980 2989 2998 3000 3002 3004 3010
	3063 3073 3158 3160 3161 3162 3165 3166 3167 3171
	3178 3185 3188 3190 3221 3241 3248 3249 3262 3263
	3268 3299 3304 3305 3310 3311 3312 3313 3315 3329
	3331 3332 3374 3376 3377 3426 3430 3431 3432 3433
	3468 3476 3477 3479 3481 3491 3523 3524 3526 3528
	3529 3544 3586 3618 3619 3620 3621 3622 3629 3630
	3660 3661 3667 3668 3669 3683 3689 3695 3705 3706
	3768 3775 3832 3834 3843 3844 3850 3851 3854 3855
	3856 3859 3862 3863 3865 3866 3867 3887 3888 3889
	3891 3892 3893 3894 3897 3898 3899 3901 3914 3917
	3932 3984 3986 3988 3997 3998 3999 4002 4004 4006
	4007 4028 4060 4067 4079 4099 4100 4119 4122 4123
	4167 4170 4261 4262 4264 4267 4268 4269 4295 4301
	4304 4309 4311 4316 4324 
}
#Example:Inland Europe & Scandinavia
normal_winter = { 
	2 3 6 7 11 12 13 14 15 25
	26 37 38 39 40 41 42 43 44 45
	46 47 48 49 50 51 52 53 54 55
	56 57 58 59 60 61 62 63 66 67
	69 73 74 75 76 77 78 79 80 81
	82 83 84 85 86 87 88 89 90 91
	92 93 94 95 96 97 98 99 100 102
	103 104 107 110 111 128 155 157 158 162
	166 167 168 169 170 171 172 173 176 177
	181 182 183 184 185 186 187 188 189 197
	201 202 204 205 206 207 208 209 210 211
	212 233 234 235 236 237 238 239 240 241
	242 243 244 245 246 247 248 249 250 251
	254 255 256 257 258 259 260 261 262 263
	264 268 269 270 271 272 273 274 275 276
	277 278 279 280 281 289 292 293 294 295
	296 297 298 299 300 301 302 303 304 305
	306 307 308 311 367 370 371 372 373 374
	375 376 414 416 419 420 422 423 424 425
	429 448 452 459 460 461 462 463 467 470
	473 474 475 477 478 479 480 577 676 693
	697 701 702 703 705 706 707 708 709 710
	711 712 713 714 715 716 717 718 719 720
	721 722 723 724 725 726 727 728 729 730
	731 739 741 742 743 767 770 771 798 854
	875 876 877 878 879 880 881 882 883 884
	885 893 916 918 920 922 924 925 926 935
	936 938 940 942 943 946 947 948 949 951
	954 957 958 960 961 964 965 966 967 968
	969 980 981 982 983 984 985 986 990 993
	994 995 996 997 1004 1005 1007 1008 1031 1033
	1035 1043 1045 1046 1047 1048 1049 1050 1051 1052
	1053 1054 1055 1056 1057 1058 1059 1060 1061 1062
	1063 1064 1065 1066 1067 1068 1069 1070 1071 1072
	1074 1075 1076 1078 1079 1080 1081 1082 1084 1086
	1087 1089 1090 1091 1092 1094 1098 1102 1103 1104
	1105 1106 1107 1108 1109 1164 1165 1166 1203 1204
	1218 1236 1237 1239 1242 1246 1248 1252 1260 1263
	1264 1324 1350 1382 1388 1406 1408 1411 1412 1413
	1414 1415 1416 1417 1418 1419 1420 1421 1422 1423
	1424 1425 1426 1427 1428 1429 1430 1431 1432 1443
	1444 1445 1449 1454 1455 1456 1457 1458 1460 1482
	1483 1484 1503 1564 1567 1578 1598 1599 1600 1601
	1602 1605 1608 1609 1625 1626 1627 1628 1629 1630
	1631 1632 1642 1643 1644 1645 1646 1647 1652 1653
	1654 1655 1662 1666 1667 1669 1670 1671 1672 1675
	1676 1679 1723 1726 1732 1734 1742 1743 1744 1745
	1752 1753 1754 1758 1759 1761 1762 1763 1768 1769
	1771 1774 1775 1778 1784 1785 1786 1790 1791 1799
	1800 1803 1804 1808 1834 1841 1847 1850 1852 1856
	1857 1858 1859 1860 1861 1865 1866 1871 1873 1874
	1875 1876 1878 1879 1883 1885 1888 1890 1893 1894
	1897 1905 1906 1931 1935 1936 1937 1938 1939 1940
	1941 1942 1945 1951 1952 1953 1956 1959 1960 1965
	1966 1969 1972 1977 1982 1983 1984 1986 1990 1991
	1992 1993 1999 2000 2004 2005 2006 2007 2009 2010
	2011 2012 2102 2103 2104 2105 2106 2107 2108 2109
	2110 2111 2112 2114 2115 2116 2117 2118 2119 2120
	2121 2122 2123 2124 2125 2126 2127 2129 2134 2136
	2167 2170 2177 2179 2182 2184 2185 2186 2187 2188
	2189 2190 2191 2192 2193 2194 2196 2197 2198 2200
	2201 2202 2203 2204 2205 2206 2207 2212 2213 2215
	2226 2307 2353 2354 2355 2356 2357 2358 2360 2361
	2363 2364 2368 2369 2407 2408 2415 2418 2419 2421
	2422 2423 2424 2425 2426 2427 2428 2429 2430 2431
	2432 2433 2434 2435 2436 2437 2438 2439 2440 2441
	2442 2443 2444 2445 2446 2482 2523 2529 2530 2532
	2533 2534 2540 2541 2543 2546 2547 2548 2552 2553
	2554 2555 2556 2557 2558 2562 2566 2567 2568 2569
	2570 2571 2572 2573 2574 2575 2576 2577 2579 2580
	2582 2583 2629 2638 2639 2641 2642 2643 2670 2673
	2701 2703 2720 2726 2727 2728 2729 2730 2731 2732
	2733 2734 2735 2736 2737 2738 2739 2742 2743 2744
	2747 2785 2795 2856 2864 2880 2950 2951 2952 2953
	2958 2959 2960 2961 2962 2963 2964 2965 2966 2967
	2969 2971 2972 2973 2974 2975 2979 2987 2991 2992
	2993 2994 2995 2996 2997 3007 3008 3009 3011 3012
	3013 3014 3015 3016 3017 3018 3019 3020 3021 3022
	3023 3024 3025 3026 3027 3028 3029 3030 3031 3032
	3033 3034 3035 3036 3037 3038 3039 3040 3041 3042
	3043 3044 3045 3046 3047 3048 3049 3050 3051 3052
	3053 3054 3055 3056 3057 3058 3059 3060 3061 3062
	3064 3065 3066 3067 3068 3069 3070 3071 3072 3074
	3075 3076 3077 3078 3079 3080 3081 3082 3083 3084
	3085 3086 3087 3088 3089 3090 3091 3092 3093 3094
	3095 3096 3097 3098 3099 3100 3102 3103 3104 3105
	3106 3107 3108 3109 3110 3111 3112 3113 3114 3116
	3117 3128 3129 3130 3131 3132 3133 3134 3136 3153
	3157 3159 3163 3164 3175 3176 3193 3250 3251 3252
	3253 3254 3255 3256 3257 3258 3264 3265 3267 3273
	3274 3275 3276 3277 3278 3279 3284 3285 3286 3288
	3289 3290 3291 3292 3293 3294 3296 3297 3298 3300
	3302 3303 3307 3308 3309 3316 3330 3337 3338 3339
	3340 3341 3342 3343 3344 3345 3346 3347 3349 3351
	3352 3353 3354 3355 3356 3357 3358 3359 3360 3369
	3373 3375 3378 3379 3380 3381 3382 3383 3384 3385
	3386 3388 3389 3390 3391 3392 3394 3395 3397 3401
	3402 3404 3436 3437 3438 3439 3440 3441 3442 3443
	3472 3474 3475 3498 3499 3500 3502 3503 3504 3505
	3506 3507 3508 3509 3510 3511 3512 3513 3514 3515
	3516 3517 3518 3519 3520 3521 3522 3525 3527 3540
	3651 3653 3655 3656 3659 3662 3663 3664 3665 3666
	3670 3671 3672 3673 3674 3675 3676 3677 3678 3679
	3680 3681 3682 3691 3692 3696 3762 3763 3773 3776
	3786 3787 3789 3790 3791 3792 3793 3794 3795 3796
	3797 3798 3799 3800 3801 3802 3803 3804 3805 3806
	3807 3808 3809 3810 3811 3812 3813 3814 3815 3816
	3817 3818 3819 3820 3821 3822 3823 3824 3825 3826
	3827 3828 3829 3830 3831 3833 3845 3846 3847 3848
	3849 3852 3857 3860 3875 3876 3877 3878 3879 3880
	3881 3882 3883 3884 3885 3886 3890 3895 3900 3903
	3905 3907 3908 3909 3911 3912 3913 3918 3920 3922
	3923 3949 3950 3983 3985 3990 3991 3993 3996 4000
	4001 4003 4005 4010 4012 4013 4014 4015 4016 4017
	4018 4019 4020 4021 4022 4023 4024 4025 4026 4032
	4042 4048 4050 4051 4055 4058 4059 4061 4063 4064
	4065 4066 4068 4069 4070 4071 4072 4073 4074 4075
	4076 4101 4103 4124 4125 4126 4127 4134 4135 4136
	4137 4138 4139 4148 4162 4175 4189 4191 4195 4260
	4263 4265 4270 4271 4272 4273 4274 4275 4276 4277
	4281 4282 4283 4284 4285 4286 4287 4288 4289 4290
	4291 4292 4293 4294 4296 4298 4299 4303 4308 4315
}
#Example:Russia & Lappland
severe_winter = { 
	1 4 5 8 9 10 16 17 19 22
	23 24 27 28 29 30 31 32 33 34
	35 36 252 253 309 310 312 314 369 481
	482 483 484 485 486 487 488 489 490 491
	492 493 494 495 496 497 498 499 500 677
	835 836 837 838 839 840 841 842 843 844
	845 846 847 848 849 850 851 852 853 855
	856 857 858 859 860 861 862 863 864 865
	866 867 868 869 870 871 872 873 874 911
	914 944 945 971 975 987 988 989 991 992
	998 999 1000 1001 1002 1003 1032 1042 1077 1083
	1088 1251 1262 1603 1604 1755 1760 1787 1842 1881
	1884 1895 1930 1957 1958 1961 1962 1963 1964 1978
	1979 1985 2013 2071 2074 2128 2130 2132 2521 2522
	2563 2564 2565 2581 2585 2587 2588 2589 2590 2749
	2752 2981 3101 3115 3118 3119 3120 3121 3122 3123
	3124 3125 3126 3127 3135 3137 3138 3139 3140 3141
	3142 3143 3144 3145 3146 3147 3148 3149 3150 3151
	3152 3154 3155 3247 3259 3260 3261 3266 3280 3281
	3282 3283 3301 3387 3393 3396 3398 3399 3400 3403
	3501 3652 3654 3657 3658 3853 3858 3861 3864 3896
	3902 3904 3906 3910 3915 4027 4029 4034 4035 4266
	4278 4279 4280 4297 
}
impassable = { 
	1779 1784 1785 1786 1787 1788 1793 1794 1795 1796
	1950 2194 2200 2251 2334 1088 1093 1094 2691 2584
	1273 3307 3309 3316 3293 3315 3944 3314 3413 1660
	1663 1241 1684 1505 1610 1924 1041 3101 2499 3213
	3209 3210 3211 3212 2722 3072 3073 3465 3968 1042
	3537 3538 3539 3981 3980 3540 4134 3993 3999 3659
	3794 3945 3291 3306 3304 3706 3305 3459 3458 3292
	3296 3900 3297 3298 3294 3299 3283 4170 4139
	#
	4185 4144
}
mild_monsoon = { 
	2087 2398 2397 583 2400 1014 1818 1017 1019 1825
	671 2174 682 686 2146 2147 685 1821 1822 2145
	2282 2284 1158 1159 2287 2288 752 751 2286 753
	2932 797 799 801 1095 1531 2804 2805 2806 345
	347 366 368 387 388 389 399 400 401 402
	403 513 519 520 522 523 524 525 555 556
	559 562 566 570 571 572 575 582 594 595
	599 617 624 635 637 660 663 673 683 684
	736 737 754 755 757 758 759 760 761 762
	763 764 765 766 785 793 795 796 910 912
	913 921 973 974 1012 1013 1018 1020 1021 1023
	1030 1044 1093 1099 1110 1131 1156 1209 1211 1212
	1213 1215 1217 1223 1434 1437 1441 1485 1487 1488
	1489 1490 1593 1594 1595 1596 1620 1624 1658 1659
	1660 1661 1736 1737 1738 1739 1740 1741 1796 1819
	1820 1830 1832 1835 1838 1904 1912 1913 1914 2041
	2042 2045 2047 2055 2059 2060 2063 2064 2066 2067
	2072 2086 2097 2142 2143 2148 2149 2150 2151 2231
	2233 2246 2257 2259 2261 2264 2268 2269 2273 2290
	2294 2341 2342 2343 2345 2392 2396 2469 2470 2500
	2509 2510 2519 2599 2600 2601 2602 2608 2609 2610
	2614 2615 2617 2618 2619 2620 2621 2622 2660 2667
	2668 2669 2672 2674 2676 2678 2709 2716 2717 2718
	2719 2721 2722 2725 2740 2741 2745 2757 2758 2759
	2760 2761 2762 2770 2773 2782 2786 2788 2789 2790
	2791 2793 2794 2796 2814 2824 2829 2833 2835 2843
	2870 2872 2873 2874 2877 2883 2884 2885 2886 2889
	2890 2892 2918 2920 3156 3179 3182 3187 3191 3192
	3194 3200 3201 3269 3295 3317 3318 3319 3320 3321
	3322 3323 3324 3333 3364 3365 3366 3417 3420 3421
	3422 3423 3424 3496 3530 3537 3542 3543 3601 3602
	3603 3604 3623 3624 3626 3627 3632 3633 3634 3635
	3636 3637 3638 3639 3640 3702 3707 3710 3713 3714
	3715 3716 3717 3726 3727 3729 3730 3749 3754 3782
	3788 3927 3928 3931 3948 3951 3953 3954 3955 3982
	4036 4047 4052 4054 4062 4087 4088 4089 4090 4091
	4092 4095 4109 4110 4111 4112 4115 4116 4118 4128
	4130 4131 4133 4151 4157 4176 4178 4196 4200 4203
	4206 4208 4209 4221 4242 4243 4247 4253 4306 
}
normal_monsoon = { 
	2028 2038 560 2096 516 2051 2054 2053 526 2056
	2057 2093 528 740 558
	2095 614 2382 615 1844 2371 2381 613 616 2372
	610 1015 667 668 2156 2157 2158 665 2159 2161
	669 1829 2152 2153 670 1833 1824 738 2154 2155
	2162 2164 2252 2253 2267 1161 2285 1235 664 749
	750 1160 756 819 832 834 1802 503 504 505
	514 515 517 518 521 527 542 544 545 546
	548 550 551 553 561 563 564 567 568 573
	580 581 584 585 587 588 589 602 818 820
	977 1040 1111 1120 1123 1124 1134 1135 1136 1137
	1142 1148 1149 1150 1154 1155 1157 1206 1208 1210
	1351 1352 1353 1361 1401 1407 1409 1410 1448 1450
	1463 1544 1585 1597 1607 1617 1618 1621 1623 1650
	1651 1665 1789 1817 1840 1911 1948 1950 1998 2002
	2024 2025 2036 2037 2039 2044 2046 2050 2052 2058
	2081 2082 2088 2091 2092 2098 2131 2135 2163 2240
	2243 2244 2245 2248 2249 2250 2263 2265 2266 2270
	2278 2279 2280 2281 2283 2293 2384 2385 2399 2401
	2499 2501 2502 2503 2506 2507 2611 2626 2627 2630
	2631 2632 2633 2634 2635 2636 2637 2646 2652 2653
	2655 2656 2657 2658 2659 2661 2662 2663 2664 2677
	2679 2680 2684 2685 2687 2690 2692 2693 2695 2696
	2712 2713 2714 2715 2723 2724 2774 2775 2776 2777
	2781 2792 2803 2812 2813 2844 2846 2852 2866 2867
	2868 2869 2871 2878 2879 2881 2882 2887 2891 3180
	3181 3189 3199 3202 3203 3208 3214 3215 3216 3217
	3218 3219 3220 3222 3223 3224 3227 3228 3229 3230
	3234 3235 3237 3240 3242 3244 3246 3270 3271 3272
	3531 3532 3533 3534 3535 3538 3571 3574 3575 3579
	3580 3581 3589 3590 3591 3592 3593 3594 3595 3596
	3597 3598 3599 3605 3606 3607 3608 3609 3610 3611
	3612 3613 3614 3615 3616 3617 3641 3642 3643 3649
	3743 3751 3752 3753 3779 3780 3781 3783 3785 3938
	3940 3941 3942 3943 3946 3947 3956 3957 3974 3975
	3976 3977 3979 3987 3995 4033 4044 4056 4083 4084
	4085 4086 4097 4108 4114 4184 4207 4218 4228 4230
	4231 4232 4234 4236 4237 4245 4246 4250 4251 4252
}
severe_monsoon = { 
	531 2029 2030 2032 529 530 2089 547 2048 2071
	579 2402 590 1815 2403 591 592 2404 2387 593
	2390 2391 1118 2241 2289 1114 1117 2238 2251 745
	815 825 827 828 829 830 532 533 534 535
	536 537 538 539 540 541 543 549 552 569
	574 586 596 597 598 600 601 603 604 605
	606 607 608 609 611 612 618 619 620 621
	622 623 625 626 627 628 629 630 631 632
	633 634 638 639 640 641 642 643 645 647
	648 649 650 653 654 655 656 657 658 666
	747 813 814 816 817 821 826 831 1016 1022
	1100 1101 1112 1113 1115 1116 1121 1122 1125 1138
	1140 1143 1144 1145 1146 1152 1153 1162 1245 1249
	1354 1355 1356 1357 1358 1360 1400 1405 1586 1663
	1664 1823 1946 1947 1949 1995 1996 2026 2027 2031
	2033 2034 2035 2043 2049 2080 2083 2084 2085 2090
	2099 2100 2101 2160 2237 2239 2254 2255 2256 2291
	2292 2295 2373 2374 2375 2376 2377 2378 2379 2380
	2383 2386 2388 2389 2645 2681 2682 2683 2697 2698
	2699 2700 2702 2704 2705 2706 2707 2708 2710 2711
	2763 2811 2845 2847 2848 2849 2850 2851 2853 2854
	2855 2857 2859 2860 2861 2862 2863 2865 2888 3204
	3205 3206 3207 3209 3210 3211 3212 3213 3225 3226
	3233 3236 3238 3239 3485 3486 3487 3488 3489 3490
	3492 3493 3536 3545 3546 3547 3549 3550 3551 3552
	3553 3554 3555 3556 3557 3558 3559 3560 3561 3562
	3563 3564 3565 3566 3567 3568 3569 3570 3572 3573
	3576 3578 3582 3583 3584 3585 3587 3588 3784 3939
	3958 3959 3960 3961 3962 3963 3964 3965 3966 3967
	3969 3970 3971 3972 3973 3978 3980 3981 4037 4039
	4043 4045 4046 4053 4057 4093 4094 4096 4149 4215
	4216 4217 4219 4220 4229 4233 4235 
}
equator_y_on_province_image = 1100
