any_coastal_seazone = { #use for triggers
	1266 1267 1268 1269 1270 1271 1272 1274 1275 1276 1278 1279 1280 1281 1282 1283 1284 1285 1286 1287 1288 1290 1291 1292
	1293 1299 1330 1331 1332 1333 1336 1337 1338 1339 1340 1341 1342 1343 1344 1346 1349 1396 1403
	1435 1438 1440 1446
	1451 1453 1468 1469 1470 1471 1472 1476
 
 
	1566 1614 1616 1673
	1929 1253 1254 1255 1256 1257 1258 1259 1294 1295
	1296 1297 1298 1300 1301 1302 1303 1304 1305 1307 1308 1309 1310 1311 1312 1313 1314 1315 1316 1317 1319 1320 1321 1322 1323 1324
	1328 1329 1334 1335 1345 1347 1348 1364 1365 1366 1368 1369
	1370 1371 1372 1373 1374 1375 1376 1377 1378 1379 1380 1381 1383 1384 1385 1386 1387 1388 1389 1390 1391 1392 1393 1395 1397
	1402 1926 1927 1928 1932 1980
}
every_coastal_seazone = { #use for effects
	1266 1267 1268 1269 1270 1271 1272 1274 1275 1276 1278 1279 1280 1281 1282 1283 1284 1285 1286 1287 1288 1290 1291 1292
	1293 1299 1330 1331 1332 1333 1336 1337 1338 1339 1340 1341 1342 1343 1344 1346 1349 1396 1403
	1435 1438 1440 1446
	1451 1453 1468 1469 1470 1471 1472 1476
 
 
	1566 1614 1616 1673
	1929 1253 1254 1255 1256 1257 1258 1259 1294 1295
	1296 1297 1298 1300 1301 1302 1303 1304 1305 1307 1308 1309 1310 1311 1312 1313 1314 1315 1316 1317 1319 1320 1321 1322 1323 1324
	1328 1329 1334 1335 1345 1347 1348 1364 1365 1366 1368 1369
	1370 1371 1372 1373 1374 1375 1376 1377 1378 1379 1380 1381 1383 1384 1385 1386 1387 1388 1389 1390 1391 1392 1393 1395 1397
	1402 1926 1927 1928 1932 1980
}
any_teleporter_province = { #use for triggers (ONLY CHECKS THE GATE PROVINCES)
}
every_teleporter_province = { #use for effect (ONLY CHECKS THE GATE PROVINCES)
}
any_teleporter = { # use for triggers (ONLY CHECKS THE ISLAND PROVINCES)
	1099
}
every_teleporter = { # use for effect (ONLY CHECKS THE ISLAND PROVINCES)
	1099
}
any_cultural_centre = { # Use for triggers
	219 183 118 236 344 1821 677 2190 1029
}
every_trade_node = { # use for effect
	679 682 1371 584 1365 1397 677 1388 731 2116 700 1389 1064 2124 1343 524 507 1948 1340 504 1149 1132 1110 2772 1334 454 1335 464 1082 377 358 341 1320 1322 280 33 137 262 1926 1293 1975 1276 188 2957 1269 1298 45
}